31 28 28 28 28 28 28 28 28 28 28 28 28 28 28 28 28 28 28 28 28 28 28 28 28 28 30
29 16 16 17 1 1 7 3 3 3 3 3 6 1 1 1 7 3 3 3 3 3 3 3 3 6 29
29 22 25 23 1 1 8 2 2 2 2 12 4 1 26 1 5 13 2 2 2 2 2 2 2 9 29
29 7 3 6 1 1 21 19 15 19 20 5 4 1 1 1 5 4 21 19 19 19 19 19 15 20 29
29 5 0 4 1 1 24 22 15 22 23 8 9 14 14 14 8 9 24 22 22 22 22 22 15 23 29
29 8 2 9 1 1 1 1 15 1 1 21 20 1 1 1 21 20 1 1 1 1 1 1 15 1 29
29 21 15 20 1 26 1 7 3 6 1 24 23 1 1 1 24 23 1 1 27 1 1 7 3 6 29
29 24 15 23 1 1 1 5 0 4 1 1 1 7 3 6 1 1 1 1 1 1 1 5 0 4 29
29 1 15 1 1 1 1 8 2 9 14 14 14 5 0 4 1 1 7 3 6 14 14 5 0 4 29
29 7 3 6 1 1 1 21 19 20 1 1 1 5 0 4 1 1 5 0 4 1 1 8 2 9 29
29 5 0 4 1 1 1 24 22 23 1 27 1 5 0 4 1 1 5 0 4 1 1 21 19 20 29
29 5 0 10 3 3 6 1 1 1 7 3 3 11 0 4 1 1 5 0 4 1 1 24 22 23 29
29 8 2 2 2 2 9 14 14 14 8 2 2 2 2 9 1 1 8 2 9 1 1 1 1 1 29
29 21 19 19 19 19 20 1 1 1 21 19 19 19 19 20 1 1 21 19 20 1 1 26 1 1 29
32 28 28 28 28 28 28 28 28 28 28 28 28 28 28 28 28 28 28 28 28 28 28 28 28 28 33