16 16 17 5 0 0 0 4 1 1 5 4 18 16 16 16 17 5 4 1 1 18 16 16 17
22 25 23 5 0 0 0 4 14 14 5 4 18 16 16 16 17 5 4 1 1 24 22 22 23
7 3 3 11 13 2 2 9 1 1 5 4 24 22 22 22 23 5 4 1 1 7 3 3 6
5 0 0 0 4 21 19 20 1 1 5 10 3 3 3 3 3 11 4 14 14 5 0 0 4
8 2 2 2 9 18 16 17 1 1 8 2 2 2 2 2 2 2 9 1 1 5 0 0 4
21 19 19 19 20 1 1 1 1 1 21 19 19 19 19 19 19 19 20 1 1 5 0 0 4
24 22 22 22 23 1 1 26 1 1 24 22 22 22 22 22 22 22 23 1 1 5 0 0 4
1 1 1 1 1 1 1 1 1 1 1 1 1 1 1 1 1 1 1 1 1 8 2 2 9
1 1 7 3 3 3 6 1 1 1 7 3 3 3 6 1 1 1 1 1 1 21 19 15 20
1 1 5 0 0 0 4 14 14 14 5 0 0 0 10 3 6 1 27 1 1 24 22 15 23
1 1 8 2 2 2 9 1 1 1 8 2 2 2 12 0 4 1 1 1 1 1 1 15 1
1 1 21 19 19 19 20 1 26 1 21 19 19 20 8 2 9 14 14 7 3 3 3 3 6
1 1 24 22 22 22 23 1 1 1 24 22 22 23 21 19 20 1 1 5 0 0 0 0 4
